WEEK,WEEK_1_ENDURANCE,WEEK_1_ENDURANCE,WEEK_1_ENDURANCE,WEEK_1_ENDURANCE,WEEK_1_ENDURANCE,WEEK_1_ENDURANCE,WEEK_2_ENDURANCE,WEEK_2_ENDURANCE,WEEK_2_ENDURANCE,WEEK_2_ENDURANCE,WEEK_2_ENDURANCE,WEEK_2_ENDURANCE,WEEK_3_ENDURANCE,WEEK_3_ENDURANCE,WEEK_3_ENDURANCE,WEEK_3_ENDURANCE,WEEK_3_ENDURANCE,WEEK_3_ENDURANCE,WEEK_4_ENDURANCE,WEEK_4_ENDURANCE,WEEK_4_ENDURANCE,WEEK_4_ENDURANCE,WEEK_4_ENDURANCE,WEEK_4_ENDURANCE
Day,8.14.23,8.15.23,8.16.23,8.17.23,8.18.23,8.19.23,8.21.23,8.22.23,8.23.23,8.24.23,8.25.23,8.26.23,8.28.23,8.29.23,8.30.23,8.31.23,9.1.23,9.2.23,9.4.23,9.5.23,9.6.23,9.7.23,9.8.23,9.9.23
Primer,300m Row,20 Box Jumps,25 Kb Swings,,Eccentric Push Ups,15 Vertical Jumps,Hip Airplane,40yd Broad Jump,20 Box Jumps,,10 Pressing Snatch Balance,20 Plyo Push Ups,25 Kb Swings,12 Squat Sit BNP,20 Box Jumps,,15 Med Ball Chest Pass,20 Vertical Jumps,,20 Box Jumps,Movement Prep 1,,Movement Prep 1,15 Sott's Press
Strength,ref 5.24.23 and 3.1.23,,ref 5.23.23 and 2.28.23,,,,,,ref 9.28 and 12.19.22,,ref 5.26.23,ref 6.3.23,ref 3.24.23,,,,Final Friday (ref 6.16.23),ref 3.8.23,Labor Day,,ref 3.15| 6.14.23 & 12.21.22,,ref 12.14.22 & 3.20.23,ref 6.10.23 and 3.4.23
Athlete,Back Squats 5x5@ 75%,Hang Snatch 5x5@ 65%,Deadlifts 5x5@ 75%,,Bench 5x5@ 75%,Hang Clean 5x5@ 65%,Deadlifts 5x5@ 77%,3 Position Clean 6x3@ 65%,Back Squats 5x5@ 77%,,3 Position Snatch 6x3@ 65%,Bench 5x5@ 77%,Back Squats 5x5@ 80%,Hang Snatch 6x4@ 65%,Deadlifts 5x5@ 80%,,Bench 5x5@ 80%,Hang Clean 6x4@ 65%,,Back Squats 2x9@ 70%,Broad Jumps 10x1,,Hang Snatch + OHS 6x3@ 65%,Hang Clean + Fr Sq 6x3@ 65%
Enthusiast,Back Squats 5x5@ 70%,Hang Power Snatch 5x5@ 115/75,Deadlifts 5x5@ 70%,,Bench 5x5@ 70%,Hang Power Clean 5x5@ 155/95,Deadlifts 5x5@ 75%,3 Position Power Clean 6x3@ 155/95,Back Squats 5x5@ 75%,,3 Position Power Snatch 6x3@ 115/75,Bench 5x5@ 75%,Back Squats 5x5@ 75%,Hang Power Snatch 6x4@ 115/75,Deadlifts 5x5@ 75%,,Bench 5x5@ 75%,Hang Power Clean 6x4@ 155/95,,Back Squats 2x9@ 65%,Broad Jumps 10x1,,Hang Power Snatch + OHS 6x3@ 115/75,Hang Power Clean + Fr Sq 6x3@ 155/95
Foundation,Back Squats 5x5@ 115/75,Hang Muscle Snatch 5x5@ 75/45,RDL's 5x5@ 155/85,,Bench  5x5@ 95/65,Hang Muscle Clean 5x5@ 95/65,RDL's 5x5@ 165/90,3 Position Db Muscle Clean 6x3@ 40's/25's,Box Squats 5x5@ 125/85,,3 Position Db Muscle Snatch 6x3@ 25's/15's,Bench 5x5@ 105/75,Box Squats 5x5@ 135/95,Hang Db Muscle Snatch 6x4@ 25's/15's,RDL's  5x5@ 175/95,,Bench 5x5@ 115/85,Hang Db Muscle Clean 6x4@ 40's/25's,,Box Squats 2x9@ 95/65,Broad Jumps 10x1,,Overhead Squat 6x3@ AHvyAP,Front Squat 6x3@ AHvyAP
At-Home,Tempo Squats  5x5@ 5511,Pressing Snatch Balance 5x10@ pvc,Single leg RDL's 5x10@ bw,,Tempo Push Ups 5x5@ 5511,Vertical Jumps 15x2,Single leg RDL's 5x10ea,Vertical Jumps 20x2,Tempo Squats  5x5@ 5511,,Overhead Squats 6x7@ pvc,Tempo Push Ups 5x5@ 5511,Tempo Squats  5x5@ 7711,Squat Sit BNP 6x10@ pvc,Single Leg RDL 5x10ea,,Tempo Push Ups 5x5@ 7711,Sott's Press 6x10@ pvc,,Single Leg Squats 2x 10ea @ bw,Broad Jumps 10x1,,Overhead Squat 6x3@ AHvyAP,Sott's Press 6x10@ pvc
,A- Med | L- Med,A- Lt | L- Hvy,A- Hvy | L- Lt,,A- Lt | L- Hvy,A- Med | L- Med,A-Lt | L- Med,A- Hvy | L-Lt,A-Lt | L-Hvy,,A- Lt | L-Hvy,A- Hvy | L-Lt,A- Lt | L- Lt,A- Hvy | L-Med,A- Med | L- Hvy,,A-Med | L-Med,A- Med | L- Med,,,A- Med | L-Med,,A- Lt | L-Med,A- Med | L-Hvy
WoD,,,,Knee Pain Relief,Tabata Tidbits,,,,OPT Repeatability Test,Total Body Reset,,,,,,Knee Pain Relief,,"""Ivan""",,,,Total Body Stress Relief,,
Athlete,5rds; for time,15min AMRAP,for time,,for max reps,Partner WoD; 12min cap | YGIG,5rds; 1min ea | for max reps,for time,3rds; ea rd for time,,for time,EMOM for 12min,5rds; 1min ea station; max reps,15min AMRAP,for time,,20min AMRAP,for time,for time; Partners | YGIG,2 rounds,2000m Row*,,6 rounds; for max watts,6rds | for time 
,"10 Step Ups (40/25)(24"")",40yd Big Skips,30-20-10,,Rd 1: Jumping Lunges,6rds,RDL's (135/85),50 Shoulder Press (95/65),250m Row,,50 Dubs,10 Lunges,Row (for cal),14 DB G2O (50/35),100 Lunges (50's/35's),,10 Burpees,50 Dubs before ea round,400m Run,9 Bench Press (70%),then,,:30 Row Sprint,20 Lunges 
,8 Db Tri Ext (40's/25's),20 Bulg Split Squats,Ring Rows (flat),,Rd 2: Tuck Ups,10cal Row,Hanging Knee Raises,40 Chest to bar Pull Ups,10 Kb Swings (70/55),,40 Jumping Lunges,8 Push Press (115/75),Dubs,12 Pull Ups,80 Push Ups,,"10 Step Ups (24"")(40/25)",50-40-30-20,50 Kb Swings (70/55),2 rounds,30 Shoulder Press (115/75),,(3min rest),15 Jump Squats 
,16 Alternating V_Ups,10 Cossack Squats,Push Ups,,Rd 3: Squats,10 Burpee Over Rower,"Step Ups (24"")",30 Straight Leg Raises (20/10),10 Burpees,,30 Single Leg Squats,6 Chin Ups,Burpees,10 Shuttle Runs,60 RDL's (50's/35's),,40 Dubs,Lunges,50 Pull Ups,9 Deadlifts (70%),*use to calculate VO2 max,,,10 Burpees 
,,,Shoulder Press (95/65),,Rd 4: Banded Side Steps (Hvy+),6rds,Russian Twists (15/10),20 Shuttle Runs,10 Kb Swings (70/55),,20 Sumo Squats (55/35),,,,40 Hanging Knee Raises,,,Push Ups,400m Run,2,,,,after rd 3 and 5 complete 150 dubs
,,,,,,8 KB G2O (70/55),Db Bench (50's/35's),10 Ice Cream Makers,10 Burpees,,10 Dragon Flags,,,,20 Single Leg Squats,,,Sit Ups,"50 Step Ups (24"")",1' Row Sprints,,,,
,,,,,,8 Goblet Squats (70/55),,,10 Kb Swings (70/55,,,,,,,,,,50 Db Sh Press (40s/25s),,,,,
,,,,,,6rds,,,250m Row,,,,,,,,,,400m Run,,,,,
,,,,,,6 Chest to Bar Pull Ups,,,,,,,,,,,,,50 Goblet Squats (70/55),,,,,
,,,,,,6 Alternating Single Leg Squats,,,,,,,,,,,,,50 Push Ups,,,,,
,,,,,,,,,,,,,,,,,,,400m Run,,,,,
,,,,,,,,,,,,,,,,,,,*5 Burpee Penalty for switching,,,,,
,,,,,,,,,,,,,,,,,,,,,,,,
Enthusiast,5rds; for time,15min AMRAP,for time,,for max reps,Partner WoD; 12min cap | YGIG,5rds; 1min ea | for max reps,for time,3rds; ea rd for time,,for time,EMOM for 12min,5rds; 1min ea station; max reps,15min AMRAP,for time,,20min AMRAP,for time,for time; Partners | YGIG,2 rounds,2000m Row*,,6 rounds; for max watts,6rds | for time 
,"10 Step Ups (25/15)(20"")",40yd Big Skips,30-20-10,,Rd 1: Lunges,6rds,RDL's (115/75),50 Shoulder Press (75/55),250m Row,,25 Dubs,10 Lunges,Row (for cal),14 DB G2O (40/25),100 Lunges (40's/25's),,10 Burpee (on knees),25 Dubs before ea round,400m Run,9 Bench Press (65%),then,,:30 Row Sprint,20 Lunges 
,8 Db Tri Ext (25's/15's),20 Split Squats,Ring Rows,,Rd 2: Tuck Ups,10cal Row,Hanging Knee Raises,40 Pull Ups,10 Kb Swings (55/35),,40 Jumping Lunges,8 Push Press (95/65),Dubs,12 Box Pull Ups,80 Push Ups,,"10 Step Ups (20"")(40/25)",50-40-30-20,50 Kb Swings (55/35),2 rounds,30 Shoulder Press (95/65),,(3min rest),15 Jump Squats 
,16 Alternating V_Ups,10 Cossack Squats,Push Ups,,Rd 3: Squats,10 Burpees,"Step Ups (20"")",30 Straight Leg Raises (10/5),10 Burpees,,30 Single Leg Squats (assisted),6 Box Chin Ups,Burpees (on knees),10 Shuttle Runs,60 RDL's (40's/25's),,20 Dubs,Lunges,50 Box Pull Ups,9 Deadlifts (65%),*use to calculate VO2 max,,,10 Burpees (knees)
,,,Shoulder Press (75/45),,Rd 4: Banded Side Steps (Med),6rds,Russian Twists (bw),20 Shuttle Runs,10 Kb Swings (55/35),,20 Sumo Squats (40/25),,,,40 Hanging Knee Raises,,,Knee Push Ups,400m Run,2 rounds,,,,after rd 3 and 5 complete 75 dubs
,,,,,,8 KB G2O (55/35),Db Bench (40's/25's),10 Hanging Straight Leg Raises,10 Burpees,,10 Ecc Dragon Flags,,,,20 Single Leg Squats (assisted),,,Sit Ups,"50 Step Ups (20"")",1' Row Sprints,,,,
,,,,,,8 Goblet Squats (55/35),,,10 Kb Swings (55/35),,,,,,,,,,50 Db Sh Press (25s/15s),,,,,
,,,,,,6rds,,,250m Row,,,,,,,,,,400m Run,,,,,
,,,,,,6 Pull Ups,,,,,,,,,,,,,50 Goblet Squats (55/35),,,,,
,,,,,,6 Alt Single Leg Squats (assist),,,,,,,,,,,,,50 Knee Push Ups,,,,,
,,,,,,,,,,,,,,,,,,,400m Run,,,,,
,,,,,,,,,,,,,,,,,,,*5 Burpee Penalty for switching,,,,,
,,,,,,,,,,,,,,,,,,,,,,,,
Foundation,5rds; for time,15min AMRAP,for time,,for max reps,Partner WoD; 12min cap | YGIG,5rds; 1min ea | for max reps,for time,3rds; ea rd for time,,for time,EMOM for 12min,5rds; 1min ea station; max reps,15min AMRAP,for time,,20min AMRAP,for time,for time; Partners | YGIG,2 rounds,2000m Row*,,6 rounds; for max watts,6rds | for time 
,10 Step Ups (bw)(AHiAP),40yd Big Skips,30-20-10,,Rd 1: Split Squats,6rds,RDL's (95/65),50 Shoulder Press (65/45),250m Row,,50 Singles,10 Lunges,Row (for cal),14 DB G2O (25/15),100 Lunges (25's/15's),,10 Burpee (no push up),50 Singles before ea round,400m Run,9 Bench Press (75/55),then,,:30 Row Sprint,20 Lunges 
,8 Db Tri Ext (15's/10's),20 Split Squats,Ring Rows,,Rd 2: Tuck Ups (legs only),10cal Row,Straight Leg Raises,40 Ring Rows,10 Kb Swings (55/35),,40 Split Squats,8 Sh Press (75/45),Singles,12 Ring Rows,80 Push Ups,,10 Step Ups (AHiAP),50-40-30-20,50 Db RDL (40/25),2 rounds,30 Shoulder Press (75/45),,(3min rest),15 Squat Hops
,16 Opp Hand to Foot,10 Sumo Squats,Incline Push Ups,,Rd 3: Squats to box,10 Burpee (no push up),"Step Ups (9"")",30 Straight Leg Raises,10 Burpees,,30 Single Leg Squats (to bench),6 Ring Curls,Burpees (no push up),10 Shuttle Runs,60 RDL's (25's/15's),,40 Singles,Lunges,50 Pull Ups,9 RDLs (135/85),*use to calculate VO2 max,,,10 Burpees (no push up)
,,,Shoulder Press (45/35),,Rd 4: Banded Side Steps (<= Lt),6rds,Bicycles,20 Shuttle Runs,10 Kb Swings (55/35),,20 Sumo Squats (bw),,,,40 Hanging Knee Raises,,,Incline Push Ups,400m Run,2 rounds,,,,after rd 3 and 5 complete 150 Singles
,,,,,,8 DB G2O (40/25),Db Bench (25's/15's),10 Batwings,10 Burpees,,10 Candlesticks,,,,20 Single Leg Squats (to box),,,Crunches,50 Step Ups (AHiAP),1' Row Sprints,,,,
,,,,,,8 Goblet Squats (40/25),,,10 Kb Swings (55/35),,,,,,,,,,50 Db Sh Press (15s/10s),,,,,
,,,,,,6rds,,,250m Row,,,,,,,,,,400m Run,,,,,
,,,,,,6 Box Pull Ups,,,,,,,,,,,,,50 Goblet Squats (40/25),,,,,
,,,,,,6 Alt Single Leg Squats (to box),,,,,,,,,,,,,50 Incline Push Ups,,,,,
,,,,,,,,,,,,,,,,,,,400m Run,,,,,
,,,,,,,,,,,,,,,,,,,*5 Burpee Penalty for switching,,,,,
,,,,,,,,,,,,,,,,,,,,,,,,
At-Home,5rds; for time,15min AMRAP,for time,,for max reps,Partner WoD; 12min cap | YGIG,5rds; 1min ea | for max reps,for time,At-Home Repeatability Test,,for time,EMOM for 12min,5rds; 1min ea station; max reps,15min AMRAP,for time,,20min AMRAP,for time,for time; Partners | YGIG,2 rounds,1600m Walk/Jog/run*,,6 rounds; for max laps,6rds | for time 
,10 Step Ups (AHiAP),40yd Big Skips,30-20-10,,Rd 1: Jumping Lunges,6rds,RDL's (AHvyAP),50 Shoulder Press (AHvyAP),3rds; ea rd for time (12min rest),,50 Jumping Jacks,10 Lunges,Row (for cal),14 Burpees,100 Lunges ,,10 Burpees,50 Jumping jack before ea round,400m Run,18 Hand Release Push Ups,then ,,:30 20yd Shuttle Sprints,20 Lunges 
,8 Hand to Elbow Plank,20 Bulg Split Squats,Batwings,,Rd 2: Tuck Ups,:20 Rapid High Knees,Straight leg raises,40 Pull Ups,250m Run,,40 Jumping Lunges,8 Handstand Push Up,Singles,12 Pull Ups,80 Push Ups,,10 Step Ups (AHiAP)(AHvyAP),50-40-30-20,50 Squat Jumps,2 rounds,30 Wall Shoulder Press,,(3min rest),15 Jump Squats 
,16 Alternating V_Ups,10 Sumo Squats,Incline Push Ups,,Rd 3: Squats,10 Burpees,Step Ups (AHiAP),30 Straight Leg Raises,10 Squat Jumps,,30 Single Leg Squats (assissted),6 Bicep Curls (backpack),Burpees (no push up),10 Shuttle Runs,60 Squats,,40 Dubs,Lunges,50 Pull Ups,9ea Hip Airplanes,*use to calculate VO2 max,,,10 Burpees 
,,,Wall Shoulder Press,,Rd 4: Band Side Steps (AHvyAP),6rds,Russian Twists (bw),20 Shuttle Runs (10yd/10yd),10 Burpees,,20 Sumo Squats (bw),,,,40 Hanging Knee Raises,,,Push Ups,400m Run,2 rounds,,,,after rd 3 and 5 complete 150 dubs
,,,,,,8 G2O (AHvyAP),Incline Push Ups,10 Hanging Straight Leg Raises,10 Squat Jumps,,10 V-Ups,,,,20 Single Leg Squats,,,Sit Ups,50 Step Ups (AHiAP),1' Rapid High Knees,,,,
,,,,,,8 Goblet Squats (AHvyAP),,,10 Burpees,,,,,,,,,,50 Sh Press (AHvyAP),,,,,
,,,,,,6rds,,,10 Squat Jumps,,,,,,,,,,400m Run,,,,,
,,,,,,6 Pull Ups,,,250m Run,,,,,,,,,,50 Squats,,,,,
,,,,,,6 Alternating Single Leg Squats,,,,,,,,,,,,,50 Push Ups,,,,,
,,,,,,,,,,,,,,,,,,,400m Run,,,,,
,,,,,,,,,,,,,,,,,,,*5 Burpee Penalty for switching,,,,,
,,,,,,,,,,,,,,,,,,,,,,,,
At-Home,40 Sumo Squats,50 Banded Side Steps,50 Rev Flys (10's/5's),,3min Wall Sit,50 Lateral Flys,2min Samson St,30ea Fr | Lat | Rev Flys,2min Pigeon,,50 Banded Side Steps,30 Bicep Curls,2min Calf Stretch,30 Shoulder Press,30 GHD's,,50 Banded Side Steps,3min Plank,6min Abs,5min Down Regulate,30ea Front/Lat/Rev,,30 GHD's,5min Abs
,,,,,,,,,,,,,,,,,,,,,,,,
,5rds; for time,15min AMRAP,for time,#VALUE!,#REF!,Partner WoD; 12min cap | YGIG,5rds; 1min ea | for max reps,for time,At-Home Repeatability Test,#VALUE!,for time,EMOM for 12min,5rds; 1min ea station; max reps,15min AMRAP,for time,#VALUE!,20min AMRAP,for time,for time; Partners | YGIG,2 rounds,1600m Walk/Jog/run*,#VALUE!,6 rounds; for max laps,6rds | for time 